..------
........
........
..P.....
X.......
......O.
.....O..
----..--
