...-....
.P.-....
...-....
...-....
.O....O.
........
..XO....
........
