...-....
.P.-....
...-....
.-.-....
.O....O.
........
..XO....
........
