........
.P......
........
...-...O
.O-X-.O.
........
..-.....
........
