........
.P......
......O.
........
.O....O.
........
..X.....
.O...T..