........
........
..>....X
........
.-......
.-...O..
.-...P..
.-......
