-.......
-.......
-.......
-X...O..
-.......
........
....P...
........