........
........
........
...---O.
..-X....
..-v....
...O...-
.P....^-