........
..-.....
.-X-...O
........
...---..
....O...
..P.O..<
........
