....X...
........
........
.O.-..-.
...O.O-.
..P...-.
..>...-.
........
