........
....O...
........
...-.O..
...PX...
........
........
....^...
