........
...v....
........
...X....
...a.P..
........
...O....
........
