........
........
.d......
....-.P.
...X-...
.O..s.O.
........
........
