O..X....
........
...-....
...O....
........
........
...P....
.......O
