........
........
........
X...d.P.
........
..f.O.f.
....d...
........
