........
>.......
..----..
..-.X-..
..-.....
..------
....O.O.
....P...
