........
.P......
........
........
.O....O.
........
..XO....
......T.