....X...
.--.--..
........
........
.P.O.O..
........
...O....
........
