......-.
...O..-.
.O....-.
........
--P..O..
......-.
...-----
......X.
