..O.....
........
........
.P..O...
........
.OX.....
.....O..
--..----