........
.P......
......O.
........
.O....O.
........
.OX.....
........