........
.....OX.
........
........
...-..O.
..O-....
...-..P.
...-....
