........
........
O..T..O.
........
...XO...
O.....O.
......P.
........