......--
........
...P....
........
.X.O.-O.
......O.
........
........