........
.P......
........
........
.O....O.
........
.OX.....
......O.