O.......
.^.<.--P
.....--.
...O....
X.......
........
.O..O...
.......O
