O..X....
........
......-.
...O....
.....^^.
--...vv.
--.P....
.......O
